time,jacobian_compute_time,number_dofs,number_linear_iterations,number_nonlinear_iterations,number_nonlinear_variables,physical_memory_use,residual_compute_time,simulation_alive_time,time_step_size,total_linear_iterations,total_nonlinear_iterations
-100,0,253601,0,0,3,3605,0,0,0,0,0
0,0.657754527,253601,20,9,3,7301,2.540369441,9.122949175,100,20,9
200,1.183997515,253601,12,8,3,7518,4.50224672,14.902899068,200,32,17
600,1.38060037,253601,5,3,3,7538,5.338617738,17.36234039,400,37,20
1400,1.644021858,253601,6,4,3,7544,6.379296302,20.444092687,800,43,24
3000,2.041814405,253601,9,6,3,7551,7.88608093,24.900281247,1600,52,30
3600,2.304726261,253601,7,4,3,7557,8.993976266,28.069658402,600,59,34
5200,2.567591649,253601,7,4,3,7566,10.102879678,31.245597593,1600,66,38
7200,2.897988699,253601,8,5,3,7567,11.41563961,35.074165006,2000,74,43
8800,3.227992564,253601,8,5,3,7572,12.724022736,38.900326997,1600,82,48
10800,3.557684555,253601,8,5,3,7575,14.025214866,42.717467561,2000,90,53
12400,3.887201392,253601,8,5,3,7601,15.33626771,46.554164218,1600,98,58
14400,4.216098937,253601,10,5,3,7602,16.772523913,50.52699801,2000,108,63
16000,4.479215683,253601,8,4,3,7605,17.946773287,53.791989042,1600,116,67
18000,4.741945482,253601,11,4,3,7605,19.32166223,57.275138333,2000,127,71
19600,5.004590935,253601,10,4,3,7608,20.62050059,60.676201067,1600,137,75
21600,5.267840757,253601,10,4,3,7608,21.929497353,64.093296951,2000,147,79
23200,5.465233904,253601,7,3,3,7608,22.906818024,66.714270054,1600,154,82
25200,5.729036742,253601,11,4,3,7614,24.28290173,70.20475679,2000,165,86
26800,5.992862655,253601,10,4,3,7615,25.587621804,73.615611919,1600,175,90
28800,6.25799014,253601,10,4,3,7617,26.903684475,77.041274358,2000,185,94
30400,6.521684447,253601,10,4,3,7618,28.207145215,80.452287474,1600,195,98
32400,6.784850176,253601,10,4,3,7618,29.510613312,83.861585313,2000,205,102
34000,7.049442106,253601,10,4,3,7618,30.820747925,87.285688654,1600,215,106
36000,7.314918992,253601,10,4,3,7638,32.140795527,90.716460399,2000,225,110
37600,7.579864468,253601,10,4,3,7650,33.455037391,94.147505037,1600,235,114
39600,7.844497251,253601,10,4,3,7654,34.768974114,97.573824706,2000,245,118
41200,8.109821309,253601,10,4,3,7672,36.0819685,100.99910141,1600,255,122
43200,8.375884433,253601,10,4,3,7673,37.40953913,104.444850792,2000,265,126
44800,8.640930247,253601,10,4,3,7673,38.720668966,107.870603297,1600,275,130
46800,8.974613434,253601,11,5,3,7673,40.252197647,111.968463027,2000,286,135
48400,9.239992134,253601,10,4,3,7673,41.575884433,115.406098386,1600,296,139
50400,9.507976693,253601,10,4,3,7675,42.915986423,118.874206461,2000,306,143
52000,9.776246737,253601,10,4,3,7675,44.23858102,122.320813741,1600,316,147
54000,10.044421479,253601,10,4,3,7675,45.577030634,125.782160876,2000,326,151
55600,10.310538868,253601,10,4,3,7675,46.899098972,129.225453406,1600,336,155
57600,10.579040528,253601,11,4,3,7675,48.311733569,132.771430361,2000,347,159
59200,10.852281778,253601,11,4,3,7676,49.729558967,136.338378365,1600,358,163
61200,11.121925888,253601,11,4,3,7676,51.133581306,139.878585035,2000,369,167
62800,11.390230603,253601,11,4,3,7676,52.539351519,143.4182058,1600,380,171
64800,11.657028956,253601,10,4,3,7676,53.872265632,146.879957076,2000,390,175
66400,11.924366617,253601,10,4,3,7677,55.206232183,150.338124237,1600,400,179
68400,12.193218293,253601,11,4,3,7678,56.618277151,153.887664206,2000,411,183
70000,12.462978452,253601,10,4,3,7678,57.964868975,157.362975099,1600,421,187
72000,12.73179966,253601,10,4,3,7678,59.302060484,160.831362391,2000,431,191
73600,13.06833738,253601,14,5,3,7678,61.057814973,165.184082128,1600,445,196
75600,13.404269036,253601,14,5,3,7678,62.816311337,169.538595614,2000,459,201
77200,13.739505084,253601,14,5,3,7738,64.564385832,173.881230533,1600,473,206
79200,14.074967389,253601,14,5,3,7739,66.303419471,178.21830371,2000,487,211
80800,14.411890496,253601,15,5,3,7739,68.123479202,182.646117406,1600,502,216
82800,14.747108605,253601,14,5,3,7739,69.862112814,186.981936132,2000,516,221
84400,15.081985558,253601,17,5,3,7739,71.805532372,191.540431843,1600,533,226
86400,15.418337423,253601,15,5,3,7739,73.629841244,195.974846792,2000,548,231
88000,15.688846307,253601,11,4,3,7739,75.052510496,199.541217378,1600,559,235
91200,15.958799119,253601,9,4,3,7739,76.336660266,202.954892339,3200,568,239
97600,16.23021215,253601,10,4,3,7739,77.702722418,206.457703433,6400,578,243
110400,16.500519009,253601,10,4,3,7739,79.060425478,209.954888773,12800,588,247
136000,16.7727588,253601,12,4,3,7739,80.565261053,213.610931334,25600,600,251
187200,17.044375132,253601,12,4,3,7739,82.074578602,217.270836611,51200,612,255
289600,17.385044778,253601,16,5,3,7742,83.997697191,221.817489735,102400,628,260
494400,17.728099112,253601,18,5,3,7742,86.095128598,226.5542799,204800,646,265
904000,18.071519818,253601,17,5,3,7743,88.130934752,231.220989102,409600,663,270
1417786,18.415352756,253601,16,5,3,7743,90.095486384,235.814649095,513786,679,275
1827386,18.757315598,253601,16,5,3,7744,92.042524002,240.387731981,409600,695,280
2646586,19.101187137,253601,18,5,3,7744,94.146908481,245.135590132,819200,713,285
2754647,19.372830354,253601,10,4,3,7746,95.521533283,248.651918255,108061,723,289
3573847,19.718284701,253601,16,5,3,7746,97.50145512,253.265501708,819200,739,294
4573847,20.063415451,253601,15,5,3,7746,99.414340838,257.799751473,1000000,754,299
5439408,20.408883512,253601,15,5,3,7746,101.312332131,262.319329534,865561,769,304
6439408,20.754932085,253601,17,5,3,7746,103.372100931,267.020533967,1000000,786,309
7439408,21.099926965,253601,15,5,3,7746,105.280222228,271.553089312,1000000,801,314
8144271,21.447725964,253601,13,5,3,7746,107.035091134,275.928131003,704863,814,319
9144271,21.862035921,253601,21,6,3,7746,109.497155009,281.494052806,1000000,835,325
10144271,22.206091777,253601,14,5,3,7746,111.322477803,285.93269919,1000000,849,330
10871826,22.550193945,253601,12,5,3,7746,112.994639829,290.20564649,727555,861,335
11871826,22.895178209,253601,16,5,3,7746,114.967382479,294.806200392,1000000,877,340
12871826,23.239342142,253601,14,5,3,7746,116.794655263,299.250221291,1000000,891,345
13629456,23.581736207,253601,11,5,3,7746,118.383870474,303.431622679,757630,902,350
14629456,23.855295021,253601,12,4,3,7748,119.906410288,307.110261353,1000000,914,354
15629456,24.130401834,253601,12,4,3,7748,121.437002411,310.799107502,1000000,926,358
16415442,24.402855221,253601,11,4,3,7748,122.894531092,314.408318516,785986,937,362
17415442,24.814053371,253601,15,6,3,7748,124.910099494,319.482482474,1000000,952,368
18415442,25.087844176,253601,12,4,3,7748,126.436570506,323.168939032,1000000,964,372
19230373,25.360842735,253601,11,4,3,7750,127.897599355,326.779207932,814931,975,376
20230373,25.634994144,253601,11,4,3,7750,129.360533495,330.395805855,1000000,986,380
21230373,25.908840902,253601,12,4,3,7750,130.892590363,334.081940392,1000000,998,384
22072371,26.251710051,253601,15,5,3,7750,132.76698753,338.57935758,841998,1013,389
23072371,26.52534931,253601,12,4,3,7750,134.288613842,342.259063959,1000000,1025,393
24072371,26.936426445,253601,18,6,3,7752,136.514172376,347.568831142,1000000,1043,399
24936904,27.210763617,253601,11,4,3,7752,137.974462562,351.179982258,864533,1054,403
25936904,27.484237165,253601,11,4,3,7752,139.428454336,354.789570257,1000000,1065,407
26936904,27.757720919,253601,11,4,3,7752,140.887299026,358.400818923,1000000,1076,411
27816661,28.031400913,253601,11,4,3,7752,142.339820005,362.00890557,879757,1087,415
28816661,28.306043863,253601,11,4,3,7752,143.801549009,365.621770594,1000000,1098,419
29816661,28.580703615,253601,11,4,3,7754,145.264961844,369.244275606,1000000,1109,423
30706657,28.855168951,253601,11,4,3,7754,146.725527788,372.860891063,889996,1120,427
31706657,29.197401294,253601,16,5,3,7756,148.670726482,377.440429582,1000000,1136,432
32706657,29.540618146,253601,16,5,3,7756,150.62157058,382.020010174,1000000,1152,437
33604381,29.881991367,253601,16,5,3,7756,152.565216369,386.595540533,897724,1168,442
34604381,30.223602175,253601,17,5,3,7756,154.580522043,391.252316567,1000000,1185,447
35604381,30.565750474,253601,17,5,3,7756,156.58249951,395.898325245,1000000,1202,452
36566112,30.907950552,253601,19,5,3,7756,158.725284179,400.69128986,961731,1221,457
36566472,31.590792447,253601,33,10,3,7756,162.42094173,409.374209318,360,1254,467
36647821.625,55.293936107,253601,96,36,3,7853,276.035865164,682.242185859,81349.625,1350,503
36729171.25,55.713210164,253601,27,6,3,7853,278.854195772,688.229502131,81349.625,1377,509
36891870.5,56.138106704,253601,27,6,3,7853,281.720063304,694.269755202,162699.25,1404,515
37217269,56.633703591,253601,31,7,3,7857,284.984010383,701.189465362,325398.5,1435,522
37868066,57.134446473,253601,31,7,3,7857,288.286024261,708.159333202,650797,1466,529
37874142,57.485609603,253601,20,5,3,7857,290.44673459,713.008061241,6076,1486,534
38524939,57.98570371,253601,29,7,3,7857,293.589283547,719.808668123,650797,1515,541
39196531,58.486696179,253601,30,7,3,7857,296.812055158,726.734430006,671592,1545,548
39216868.40625,97.230349918,253601,103,43,3,7871,480.291106297,1170.220059794,20337.40625,1648,591
39237205.8125,97.582748253,253601,18,5,3,7889,482.315226617,1174.924536924,20337.40625,1666,596
39277880.625,97.935266723,253601,18,5,3,7889,484.349462594,1179.650007104,40674.8125,1684,601
39359230.25,98.364208887,253601,25,6,3,7889,487.04467828,1185.547099415,81349.625,1709,607
39521929.5,98.866954363,253601,28,7,3,7889,490.128476064,1192.322828403,162699.25,1737,614
39847328,99.36718242,253601,27,7,3,7889,493.124847935,1199.002739006,325398.5,1764,621
40498125,99.868362734,253601,28,7,3,7889,496.189416416,1205.785701196,650797,1792,628
41498125,100.371500819,253601,27,7,3,7894,499.198272169,1212.525462559,1000000,1819,635
41679735.5,108.066237032,253601,25,7,3,7894,535.603343167,1301.322878802,181610.5,1844,642
41861346,108.496320688,253601,22,6,3,7894,538.121372999,1307.077208278,181610.5,1866,648
41952151.25,125.054033503,253601,84,31,3,7903,614.716430591,1496.196796758,90805.25,1950,679
42042956.5,125.410967569,253601,18,5,3,7903,616.80717059,1501.038044898,90805.25,1968,684
42224567,125.841691035,253601,26,6,3,7903,619.61442358,1507.106410714,181610.5,1994,690
42587788,126.274469704,253601,23,6,3,7903,622.22101481,1512.970717789,363221,2017,696
43314230,126.778194715,253601,27,7,3,7903,625.226930447,1519.72432246,726442,2044,703
44314230,127.280082671,253601,28,7,3,7903,628.297486336,1526.549161557,1000000,2072,710
44551637,127.711462018,253601,28,6,3,7903,631.25404018,1532.789350104,237407,2100,716
45551637,132.237345571,253601,181,63,3,7903,652.926084736,1585.48004711,1000000,2281,779
46551637,132.739530726,253601,27,7,3,7903,655.938704717,1592.246712098,1000000,2308,786
47270521,133.170080106,253601,21,6,3,7903,658.393611536,1597.947175553,718884,2329,792
47770521,140.883784456,253601,30,7,3,7905,695.245791294,1687.602147475,500000,2359,799
48270521,141.315929173,253601,23,6,3,7906,697.837663405,1693.456572823,500000,2382,805
49270521,141.820135535,253601,28,7,3,7910,700.948453287,1700.339294503,1000000,2410,812
50018611,142.251549203,253601,23,6,3,7910,703.545870381,1706.19995049,748090,2433,818
51018611,143.407943801,253601,50,16,3,7910,709.49544599,1720.305790324,1000000,2483,834
52018611,143.839959372,253601,23,6,3,7910,712.095963337,1726.176263471,1000000,2506,840
52796543,144.273634578,253601,23,6,3,7910,714.721171169,1732.074912776,777932,2529,846
53296543,151.984521487,253601,28,7,3,7928,752.421128745,1822.710150213,500000,2557,853
53796543,152.416258641,253601,23,6,3,7928,755.031672681,1828.588336033,500000,2580,859
54796543,153.49494632,253601,46,15,3,7928,760.508577779,1841.718407905,1000000,2626,874
55599376,153.926195435,253601,24,6,3,7928,763.181296612,1847.66816981,802833,2650,880
56599376,154.358243575,253601,23,6,3,7928,765.786918596,1853.547003436,1000000,2673,886
57599376,155.437465092,253601,46,15,3,7928,771.281650887,1866.70807459,1000000,2719,901
58427562,155.867309607,253601,22,6,3,7928,773.804340566,1872.500016649,828186,2741,907
59427562,156.298449195,253601,21,6,3,7930,776.258994716,1878.217720331,1000000,2762,913
60427562,157.375440759,253601,44,15,3,7930,781.586593807,1891.19448459,1000000,2806,928
61278671,157.804095582,253601,22,6,3,7930,784.099393914,1896.969398509,851109,2828,934
62278671,160.032945229,253601,82,31,3,7930,794.362580562,1922.694435063,1000000,2910,965
63278671,160.463657459,253601,22,6,3,7930,796.895153852,1928.488986506,1000000,2932,971
64150145,160.894024612,253601,22,6,3,7930,799.4357865,1934.298871033,871474,2954,977
65150145,161.324676456,253601,21,6,3,7932,801.906093103,1940.032668075,1000000,2975,983
66150145,162.402030039,253601,45,15,3,7932,807.318841069,1953.106239253,1000000,3020,998
67039308,162.83412304,253601,21,6,3,7932,809.785548402,1958.83656755,889163,3041,1004
68039308,163.263836001,253601,20,6,3,7932,812.176581812,1964.481882592,1000000,3061,1010
69039308,164.341477541,253601,41,15,3,7932,817.321661931,1977.272684143,1000000,3102,1025
69940385,164.773192526,253601,22,6,3,7932,819.852084311,1983.073884512,901077,3124,1031
70940385,165.206047178,253601,21,6,3,7937,822.319953312,1988.809191837,1000000,3145,1037
71940385,166.28317276,253601,44,15,3,7937,827.661993271,2001.799373229,1000000,3189,1052
72847456,166.71341786,253601,22,6,3,7937,830.19262703,2007.594694879,907071,3211,1058
73815510,167.14275305,253601,21,6,3,7937,832.651092069,2013.313627496,968054,3232,1064
73815600,183.202478526,253601,63,27,3,7939,903.329141972,2195.101764969,90,3295,1091
73815690,183.908059295,253601,34,10,3,7939,907.140699194,2204.127663375,90,3329,1101
73815870,185.321865145,253601,62,20,3,7939,914.225303403,2221.30555308,180,3391,1121
73816230,185.959347494,253601,29,9,3,7941,917.580150385,2229.379116085,360,3420,1130
73816950,186.243729896,253601,15,4,3,7941,919.287755279,2233.355724667,720,3435,1134
73818390,186.525848189,253601,11,4,3,7941,920.708789575,2237.023933537,1440,3446,1138
73821270,186.80873791,253601,12,4,3,7941,922.20944139,2240.776480894,2880,3458,1142
73827030,187.090720393,253601,11,4,3,7941,923.646508515,2244.461573182,5760,3469,1146
73838550,187.373619075,253601,11,4,3,7941,925.088537288,2248.153613278,11520,3480,1150
73861590,187.656724475,253601,11,4,3,7941,926.525746409,2251.841761036,23040,3491,1154
73907670,188.010817795,253601,17,5,3,7941,928.512515807,2256.585585612,46080,3508,1159
73999830,188.437996599,253601,17,6,3,7941,930.665844437,2261.973019709,92160,3525,1165
74184150,188.869995183,253601,19,6,3,7946,933.000375639,2267.56088089,184320,3544,1171
74512357,189.30221955,253601,22,6,3,7946,935.54702792,2273.391303575,328207,3566,1177
74696677,189.805760052,253601,19,7,3,7946,938.015674924,2279.582826791,184320,3585,1184
75065317,190.238347919,253601,20,6,3,7946,940.418134935,2285.245790184,368640,3605,1190
75208844,190.597256379,253601,19,5,3,7946,942.59257064,2290.198913541,143527,3624,1195
75577484,191.028831766,253601,21,6,3,7946,945.070432403,2295.944495786,368640,3645,1201
76314764,191.462282475,253601,21,6,3,7946,947.554403087,2301.703385158,737280,3666,1207
76601818,191.894232477,253601,22,6,3,7946,950.083218787,2307.507844594,287054,3688,1213
77339098,192.327610744,253601,22,6,3,7946,952.632541128,2313.331685211,737280,3710,1219
78339098,192.760708187,253601,20,6,3,7946,955.040463911,2319.004587903,1000000,3730,1225
79339098,194.999525548,253601,79,31,3,7946,965.174242509,2344.602143105,1000000,3809,1256
79387767,195.35337673,253601,17,5,3,7946,967.15317953,2349.337230977,48669,3826,1261
80387767,197.380133274,253601,68,28,3,7946,976.106274101,2372.272494056,1000000,3894,1289
81387767,197.81190153,253601,20,6,3,7946,978.503423091,2377.929125963,1000000,3914,1295
82176746,198.822435837,253601,40,14,3,7946,983.466846277,2390.053514996,788979,3954,1309
83176746,199.25470127,253601,23,6,3,7946,986.083894904,2395.951014553,1000000,3977,1315
84176746,199.687131868,253601,22,6,3,7946,988.630277591,2401.763272778,1000000,3999,1321
84968764,200.117396065,253601,21,6,3,7946,991.097692542,2407.495570532,792018,4020,1327
85968764,201.778701786,253601,59,23,3,7946,998.696221081,2426.647652498,1000000,4079,1350
86968764,202.212487331,253601,21,6,3,7946,1001.179850983,2432.398321075,1000000,4100,1356
87763826,202.644587377,253601,21,6,3,7948,1003.655460973,2438.140424553,795062,4121,1362
88763826,203.150275005,253601,25,7,3,7948,1006.557159416,2444.815756316,1000000,4146,1369
89763826,203.581328008,253601,20,6,3,7950,1008.95874415,2450.475182644,1000000,4166,1375
90555844,204.590235237,253601,39,14,3,7950,1013.854814398,2462.542134229,792018,4205,1389
91555844,205.095953075,253601,24,7,3,7950,1016.69741009,2469.149923295,1000000,4229,1396
92555844,205.530593331,253601,21,6,3,7950,1019.197020504,2474.917441554,1000000,4250,1402
93344824,206.545403439,253601,40,14,3,7951,1024.178280495,2487.080865241,788980,4290,1416
94344824,206.980022647,253601,21,6,3,7955,1026.667884738,2492.838712108,1000000,4311,1422
95344824,207.415203246,253601,20,6,3,7955,1029.092278457,2498.520873072,1000000,4331,1428
96130772,208.428355703,253601,40,14,3,7955,1034.082933255,2510.683671232,785948,4371,1442
97130772,208.861931987,253601,22,6,3,7966,1036.639816961,2516.513789826,1000000,4393,1448
98130772,209.296413519,253601,20,6,3,7966,1039.064124857,2522.196934025,1000000,4413,1454
98910677,210.384101847,253601,42,15,3,7966,1044.339443947,2535.123563993,779905,4455,1469
99910677,210.818670097,253601,21,6,3,7966,1046.831975739,2540.883565525,1000000,4476,1475
100910677,211.25260573,253601,20,6,3,7967,1049.250158887,2546.560994583,1000000,4496,1481
101684565,212.266227258,253601,41,14,3,7967,1054.299720287,2558.773846089,773888,4537,1495
102684565,212.699823822,253601,20,6,3,7967,1056.723337591,2564.457495873,1000000,4557,1501
103684565,213.134130539,253601,21,6,3,7967,1059.216145602,2570.21395128,1000000,4578,1507
104452461,214.147434019,253601,41,14,3,7967,1064.272363193,2582.434734147,767896,4619,1521
105452461,214.582072411,253601,20,6,3,7967,1066.709379444,2588.133903666,1000000,4639,1527
106452461,215.016630357,253601,21,6,3,7967,1069.214205069,2593.900185661,1000000,4660,1533
107214393,215.451085047,253601,21,6,3,7967,1071.697726998,2599.645793621,761932,4681,1539
108214393,216.538169649,253601,41,15,3,7967,1076.907906394,2612.490954569,1000000,4722,1554
109214393,216.972178563,253601,22,6,3,7967,1079.465115564,2618.317863006,1000000,4744,1560
109970384,217.405107283,253601,21,6,3,7967,1081.95516218,2624.068771055,755991,4765,1566
110596668,218.418553774,253601,38,14,3,8028,1086.799251456,2636.073970674,626284,4803,1580
110596758,237.106124776,253601,146,62,3,8039,1168.72391414,2846.043293078,90,4949,1642
110596848,238.53248265,253601,61,20,3,8039,1175.860258278,2863.258583608,90,5010,1662
110596893,256.25189269,253601,104,49,3,8046,1250.924787887,3059.760161192,45,5114,1711
110596938,260.305066192,253601,136,57,3,8048,1268.269823862,3105.054141472,45,5250,1768
110596983,269.895938453,253601,71,35,3,8053,1307.080351717,3209.575165859,45,5321,1803
110597028,274.352397676,253601,138,63,3,8053,1325.25663744,3258.463039208,45,5459,1866
110597118,275.981086624,253601,63,23,3,8053,1332.871194542,3277.55656403,90,5522,1889
110597298,276.618059633,253601,27,9,3,8053,1336.111809513,3285.50700171,180,5549,1898
110597658,277.186252839,253601,22,8,3,8053,1338.87482168,3292.465913689,360,5571,1906
110598378,277.398273853,253601,9,3,3,8053,1340.040265179,3295.394343515,720,5580,1909
110599818,277.610603608,253601,10,3,3,8053,1341.273083985,3298.395343497,1440,5590,1912
110602698,277.822892071,253601,10,3,3,8053,1342.500613333,3301.390412706,2880,5600,1915
110608458,278.106584088,253601,17,4,3,8053,1344.356448479,3305.530269422,5760,5617,1919
110619978,278.461270507,253601,18,5,3,8053,1346.420976709,3310.35400921,11520,5635,1924
110643018,278.816183798,253601,18,5,3,8053,1348.486955303,3315.169216461,23040,5653,1929
110689098,279.171592591,253601,18,5,3,8055,1350.541301151,3319.983225098,46080,5671,1934
110781258,279.527201724,253601,18,5,3,8055,1352.61152291,3324.815045179,92160,5689,1939
110965578,279.885473605,253601,19,5,3,8057,1354.786128909,3329.759209396,184320,5708,1944
111326530,280.31726508,253601,20,6,3,8057,1357.180309987,3335.404357361,360952,5728,1950
111510850,280.747827644,253601,21,6,3,8057,1359.637997745,3341.121331672,184320,5749,1956
111879490,281.252559701,253601,21,7,3,8057,1362.253890601,3347.471387813,368640,5770,1963
112051245,281.683772358,253601,21,6,3,8057,1364.704069868,3353.187816821,171755,5791,1969
112419885,282.117754873,253601,22,6,3,8057,1367.249356782,3359.005895245,368640,5813,1975
113157165,282.550909683,253601,20,6,3,8057,1369.656516298,3364.672148468,737280,5833,1981
113487481,282.983747459,253601,20,6,3,8057,1372.072939337,3370.348171585,330316,5853,1987
114224761,284.139307253,253601,44,16,3,8057,1377.610700792,3384.012927851,737280,5897,2003
115224761,284.572122811,253601,22,6,3,8057,1380.174536328,3389.83995333,1000000,5919,2009
116224761,285.005248273,253601,22,6,3,8057,1382.717309817,3395.64806706,1000000,5941,2015
116330378,285.361818057,253601,19,5,3,8059,1384.858627445,3400.553349851,105617,5960,2020
117330378,286.446706542,253601,45,15,3,8059,1390.322988024,3413.668444822,1000000,6005,2035
118330378,286.880839454,253601,22,6,3,8059,1392.886151198,3419.496507086,1000000,6027,2041
119151491,287.315026917,253601,21,6,3,8059,1395.374242006,3425.241144992,821113,6048,2047
120151491,288.400105412,253601,44,15,3,8059,1400.784289838,3438.297579159,1000000,6092,2062
121151491,288.834059936,253601,22,6,3,8064,1403.350820482,3444.125032008,1000000,6114,2068
121958265,289.268342053,253601,20,6,3,8064,1405.760714197,3449.7866531,806774,6134,2074
122958265,290.35829873,253601,43,15,3,8064,1411.109021996,3462.774654052,1000000,6177,2089
123958265,290.793446168,253601,21,6,3,8064,1413.603502099,3468.534348859,1000000,6198,2095
124754381,291.227949535,253601,21,6,3,8064,1416.089701248,3474.279560257,796116,6219,2101
125754381,291.736879215,253601,24,7,3,8064,1418.946509276,3480.897595181,1000000,6243,2108
126754381,292.172317536,253601,22,6,3,8064,1421.509100961,3486.723142283,1000000,6265,2114
127536410,292.607619413,253601,20,6,3,8064,1423.934782334,3492.402150511,782029,6285,2120
128536410,293.696303781,253601,41,15,3,8064,1429.144085269,3505.234439962,1000000,6326,2135
129536410,294.131183135,253601,21,6,3,8064,1431.629294571,3510.979351314,1000000,6347,2141
130307968,294.565466575,253601,20,6,3,8064,1434.046426938,3516.649043129,771558,6367,2147
131307968,295.727026539,253601,44,16,3,8064,1439.623556559,3530.34274233,1000000,6411,2163
132307968,296.162134367,253601,21,6,3,8064,1442.116565285,3536.099122422,1000000,6432,2169
133069132,296.595360314,253601,19,6,3,8064,1444.457815468,3541.682623143,761164,6451,2175
134069132,297.027510493,253601,19,6,3,8064,1446.797595709,3547.266548449,1000000,6470,2181
135069132,297.462190203,253601,22,6,3,8064,1449.364231811,3553.090753012,1000000,6492,2187
135819981,298.479945097,253601,37,14,3,8064,1454.153647471,3565.017916046,750849,6529,2201
136819981,298.915221458,253601,20,6,3,8064,1456.586223529,3570.708800474,1000000,6549,2207
137819981,299.350845834,253601,21,6,3,8064,1459.091978943,3576.477240692,1000000,6570,2213
138560590,299.785832058,253601,21,6,3,8064,1461.592683462,3582.23809684,740609,6591,2219
139560590,300.802659422,253601,38,14,3,8064,1466.470550385,3594.248384557,1000000,6629,2233
140560590,301.23877333,253601,21,6,3,8064,1468.986464443,3600.023731699,1000000,6650,2239
141291037,301.673563768,253601,22,6,3,8064,1471.563510627,3605.870626774,730447,6672,2245
142291037,302.109405673,253601,19,6,3,8064,1473.92426213,3611.479586491,1000000,6691,2251
143291037,302.543726683,253601,21,6,3,8066,1476.428274649,3617.23777873,1000000,6712,2257
144011395,303.56003836,253601,39,14,3,8066,1481.362060937,3629.323645875,720358,6751,2271
145011395,303.995486492,253601,20,6,3,8066,1483.799235028,3635.008478911,1000000,6771,2277
146011395,304.432867901,253601,20,6,3,8066,1486.241879129,3640.70622197,1000000,6791,2283
146526972,304.868075795,253601,20,6,3,8069,1488.677190373,3646.388951585,515577,6811,2289
146527152,313.924754323,253601,59,27,3,8076,1527.42278774,3747.087339398,180,6870,2316
146527332,317.768112563,253601,135,54,3,8076,1544.332750989,3790.481076013,180,7005,2370
146527692,318.408285064,253601,28,9,3,8076,1547.647480886,3798.483978897,360,7033,2379
146528412,318.69226008,253601,11,4,3,8076,1549.090319468,3802.16609558,720,7044,2383
146529852,318.976595968,253601,10,4,3,8076,1550.477286077,3805.786466265,1440,7054,2387
146532732,319.260776901,253601,10,4,3,8076,1551.853278561,3809.394585616,2880,7064,2391
146538492,319.544385908,253601,10,4,3,8076,1553.232123827,3813.010126946,5760,7074,2395
146550012,319.900674131,253601,14,5,3,8076,1555.028244672,3817.532734667,11520,7088,2400
146573052,320.257789486,253601,14,5,3,8076,1556.822032565,3822.05642653,23040,7102,2405
146584572,336.042803362,253601,47,22,3,8083,1623.198784673,3996.352998307,11520,7149,2427
146596092,336.391870417,253601,14,5,3,8083,1624.975813794,4000.85309386,11520,7163,2432
146619132,336.739479234,253601,14,5,3,8083,1626.741888718,4005.336789902,23040,7177,2437
146665212,337.088528145,253601,14,5,3,8083,1628.509146804,4009.825792765,46080,7191,2442
146757372,337.437636657,253601,15,5,3,8083,1630.338027508,4014.392830192,92160,7206,2447
146941692,337.859498611,253601,18,6,3,8083,1632.542463024,4019.806823258,184320,7224,2453
147256920,338.283153277,253601,19,6,3,8083,1634.83529021,4025.31630399,315228,7243,2459
147441240,338.702098856,253601,20,6,3,8083,1637.172088493,4030.879533016,184320,7263,2465
147809880,339.12678945,253601,19,6,3,8083,1639.453051995,4036.374671248,368640,7282,2471
147982421,339.54665262,253601,17,6,3,8083,1641.581955795,4041.707846462,172541,7299,2477
148351061,339.970552332,253601,21,6,3,8083,1644.014064821,4047.367748685,368640,7320,2483
149088341,340.395296535,253601,19,6,3,8083,1646.316981072,4052.892709529,737280,7339,2489
149419335,340.817720954,253601,18,6,3,8083,1648.54511845,4058.336445692,330994,7357,2495
150156615,341.874408586,253601,43,15,3,8083,1653.75449675,4071.126608191,737280,7400,2510
151156615,342.297359464,253601,19,6,3,8083,1656.035402834,4076.619872814,1000000,7419,2516
152156615,342.719311217,253601,19,6,3,8087,1658.318469373,4082.113878634,1000000,7438,2522
152261627,343.134398189,253601,19,6,3,8087,1660.529428435,4087.530128599,105012,7457,2528
153261627,343.557465014,253601,21,6,3,8087,1662.956884503,4093.186081645,1000000,7478,2534
154261627,344.611364816,253601,41,15,3,8087,1667.997748244,4105.781786078,1000000,7519,2549
155092269,345.033379804,253601,20,6,3,8087,1670.345066225,4111.345372336,830642,7539,2555
156092269,345.454960399,253601,22,6,3,8087,1672.838454098,4117.067750342,1000000,7561,2561
157092269,345.807024582,253601,17,5,3,8087,1674.856783213,4121.821159375,1000000,7578,2566
157911358,346.229272209,253601,20,6,3,8087,1677.208716478,4127.400320503,819089,7598,2572
158911358,348.489143618,253601,78,32,3,8087,1687.220480275,4153.165848715,1000000,7676,2604
159911358,348.841615769,253601,17,5,3,8089,1689.233250166,4157.916685363,1000000,7693,2609
160722797,349.194025905,253601,15,5,3,8089,1691.112212361,4162.521371711,811439,7708,2614
161722797,349.617244498,253601,18,6,3,8089,1693.332902267,4167.962164262,1000000,7726,2620
162722797,350.041006871,253601,21,6,3,8089,1695.768397277,4173.632265636,1000000,7747,2626
163519059,350.465202882,253601,19,6,3,8089,1698.062069772,4179.146492525,796262,7766,2632
164519059,352.516917484,253601,68,29,3,8089,1706.984422206,4202.370746509,1000000,7834,2661
165519059,352.941041652,253601,21,6,3,8089,1709.4234511,4208.047104534,1000000,7855,2667
166304046,353.365843193,253601,21,6,3,8091,1711.86422059,4213.720230655,784987,7876,2673
167304046,353.790343015,253601,20,6,3,8091,1714.243048387,4219.330102822,1000000,7896,2679
168304046,354.214667984,253601,20,6,3,8091,1716.618673581,4224.932610348,1000000,7916,2685
169077849,354.637003745,253601,20,6,3,8091,1718.989173608,4230.530540881,773803,7936,2691
170077849,355.700065174,253601,39,15,3,8091,1723.953707289,4243.066931215,1000000,7975,2706
171077849,356.690688127,253601,37,14,3,8095,1728.64602273,4254.849944894,1000000,8012,2720
171833208,357.115276191,253601,20,6,3,8095,1731.020658711,4260.450972759,755359,8032,2726
172833208,357.540085335,253601,19,6,3,8095,1733.328764267,4265.989271393,1000000,8051,2732
173833208,357.963682518,253601,21,6,3,8095,1735.773121999,4271.671523257,1000000,8072,2738
174573989,358.386887678,253601,19,6,3,8095,1738.072332757,4277.197961987,740781,8091,2744
175573989,360.945107004,253601,83,36,3,8095,1749.083134427,4305.94811369,1000000,8174,2780
176573989,361.369293711,253601,20,6,3,8095,1751.462280774,4311.561725385,1000000,8194,2786
177296762,361.795303223,253601,20,6,3,8101,1753.850623938,4317.182690153,722773,8214,2792
177922434,362.22120282,253601,18,6,3,8102,1756.095154404,4322.655163711,625672,8232,2798
177922794,363.443846231,253601,51,19,3,8102,1761.594868481,4337.229975346,360,8283,2817
